filename, language, Python, HTML, CSS, JavaScript, comment, blank, total
d:\Repos\publish-subscribe-lab\app.py, Python, 117, 0, 0, 0, 0, 29, 146
d:\Repos\publish-subscribe-lab\database.py, Python, 46, 0, 0, 0, 6, 10, 62
d:\Repos\publish-subscribe-lab\static\css\gillenwater.css, CSS, 0, 0, 41, 0, 2, 9, 52
d:\Repos\publish-subscribe-lab\static\js\publisher\publisher.js, JavaScript, 0, 0, 0, 11, 7, 9, 27
d:\Repos\publish-subscribe-lab\static\js\publisher\publisher.presenter.js, JavaScript, 0, 0, 0, 22, 4, 1, 27
d:\Repos\publish-subscribe-lab\static\js\publisher\publisher.view.js, JavaScript, 0, 0, 0, 13, 4, 2, 19
d:\Repos\publish-subscribe-lab\static\js\subscriber\subscriber.connection.js, JavaScript, 0, 0, 0, 62, 14, 10, 86
d:\Repos\publish-subscribe-lab\static\js\subscriber\subscriber.data.js, JavaScript, 0, 0, 0, 7, 2, 0, 9
d:\Repos\publish-subscribe-lab\static\js\subscriber\subscriber.js, JavaScript, 0, 0, 0, 26, 8, 8, 42
d:\Repos\publish-subscribe-lab\static\js\subscriber\subscriber.notificationService.js, JavaScript, 0, 0, 0, 48, 12, 7, 67
d:\Repos\publish-subscribe-lab\static\js\subscriber\subscriber.view.js, JavaScript, 0, 0, 0, 30, 12, 6, 48
d:\Repos\publish-subscribe-lab\static\js\utilities\cookieManager.js, JavaScript, 0, 0, 0, 25, 2, 10, 37
d:\Repos\publish-subscribe-lab\static\js\utilities\formToObjectConverter.js, JavaScript, 0, 0, 0, 18, 0, 2, 20
d:\Repos\publish-subscribe-lab\static\js\utilities\getURLparams.js, JavaScript, 0, 0, 0, 7, 2, 1, 10
d:\Repos\publish-subscribe-lab\static\js\utilities\string.extended.js, JavaScript, 0, 0, 0, 18, 4, 2, 24
d:\Repos\publish-subscribe-lab\templates\index.html, HTML, 0, 60, 0, 0, 8, 9, 77
d:\Repos\publish-subscribe-lab\templates\publish.html, HTML, 0, 40, 0, 0, 8, 9, 57
Total, -, 163, 100, 41, 287, 95, 124, 810